camperId,room
69100014,1
69100022,1
69100030,1
69100048,1
69100055,2
69100063,2
69100071,3
69100089,3
69100097,4
69100105,4
69100113,5